ğŸ¾ FAUNE NATURELLE DU MONDE DE VELKARUM

(Base biologique commune, intÃ©grÃ©e aux cycles planÃ©taires, aux ressources brutes et Ã  la synthÃ¨se gÃ©o-Ã©cologique. Toutes les espÃ¨ces sont naturelles, non magiques et biologiquement viables.)

ğŸ¦Œ I. MammifÃ¨res terrestres
Famille	Description	Habitat	ParticularitÃ©s et rÃ´le Ã©cologique
BÅ“uf des glaces	Grand bovidÃ© Ã  pelage trÃ¨s dense	Toundras, plaines froides (HelrÃ¼n, nord Eldaron)	Graisse isolante, cuir Ã©pais ; broute les lichens et maintient la neige tassÃ©e.
Cerf brun / Cerf du CÅ“ur	Grand herbivore forestier	ForÃªts tempÃ©rÃ©es dâ€™Eldaron	EspÃ¨ce clÃ© de la rÃ©gÃ©nÃ©ration forestiÃ¨re, proie fÃ©odale emblÃ©matique.
Loup cendrÃ©	PrÃ©dateur social moyen au pelage gris	ForÃªts, steppes dâ€™Eldaron et Thaurgrim nord	PrÃ©dateur rÃ©gulateur ; ancÃªtre du Chien du fer.
Ours gris	Carnivore massif omnivore	Nord Eldaron, HelrÃ¼n	Se nourrit de poissons, baies, charognes ; indicateur de santÃ© des Ã©cosystÃ¨mes borÃ©aux.
Lynx borÃ©al	FÃ©lin solitaire	ForÃªts froides	Chasseur sÃ©lectif ; contrÃ´le la population de rongeurs.
Renard des brumes	CanidÃ© argentÃ© semi-amphibie	CÃ´tes et marais tempÃ©rÃ©s	Opportuniste, charognard utile aux humains.
Cheval rude / destrier	Ã‰quidÃ© robuste	Partout sauf tropiques	Pilier du transport et de la cavalerie ; consomme herbes des plaines ferriques.
ChÃ¨vre de Lorn	Caprin montagnard	Plateaux volcaniques	Produit lait riche en minÃ©raux ; colonise les terrains pauvres du Lorn.
Sanglier noir	SuidÃ© agressif	ForÃªts tempÃ©rÃ©es	Omnivore, laboure naturellement le sol ; viande commune.
Bovin des marais	BovidÃ© amphibie	Marais du Darn (Eldaron sud)	DomestiquÃ© par les Batraciens ; filtre les eaux stagnantes.
Chien du fer	Race crÃ©Ã©e par sÃ©lection	Zones humaines (Eldaron, HelrÃ¼n)	Compagnon militaire et utilitaire, rÃ©sistant au froid et au mÃ©tal chaud.
ğŸ‰ II. Grands prÃ©dateurs et mÃ©gafaune naturelle
EspÃ¨ce	Description	Habitat	ParticularitÃ©s et fonctions
Loup gÃ©ant du nord	Variante colossale du loup cendrÃ©	HelrÃ¼n, Fer-dâ€™Acier	Meutes puissantes ; prÃ©dateur apex des steppes glacÃ©es.
Ours des neiges	Ours polaire massif	CÃ´tes dâ€™Ygral (HelrÃ¼n)	Piscivore, isolÃ© ; source majeure de graisse et cuir.
Ã‰lan de Skarn	CervidÃ© gÃ©ant	Plaines subpolaires dâ€™HelrÃ¼n	Herbivore migrateur ; maintient le pergÃ©lisol en mouvement.
LÃ©zard rocheux	Reptile robuste Ã  sang froid	Lorn, Sud-Rune (Thaurgrim)	PrÃ©dateur des zones chaudes ; cuir rÃ©sistant utilisÃ© localement.
BÅ“uf des cendres	BovidÃ© volcanique	Champs basaltiques (Thaurgrim)	Vie sur cendres chaudes, recycle minÃ©raux et chaleur du sol.
Lion des dunes	Grand fÃ©lin nocturne	Thaurgrim, Sud-Rune	Chasseur des savanes arides ; rÃ©gule les herbivores des dÃ©serts.
Griffon terrestre	Grand rapace terrestre (non volant)	Falaises cÃ´tiÃ¨res dâ€™Eldaron & Iskarion	Charognard gÃ©ant, nettoyeur des plages et champs de bataille.
Auroch gris	BovidÃ© ancien	Plaines centrales dâ€™Eldaron	AncÃªtre des bÅ“ufs domestiques ; force de trait et source de cuir.
ğŸ III. Reptiles et amphibiens
Type	Description	Habitat	Usage / impact
Crocodile de Darn	Grand amphibien carnivore	Marais dâ€™Eldaron sud	PrÃ©dateur dominant ; cuir utilisÃ© pour armures.
LÃ©zard des cendres	Petit reptile basalteux	Lorn, Sud-Rune	Sert dâ€™indicateur thermique pour forges et mines.
Serpent dâ€™ambre	Reptile dorÃ©	ForÃªts chaudes dâ€™Iskarion & VarnÃ¤l	Venin mÃ©dicinal ; chasse les rongeurs.
Tortue de sel	Reptile lent	Plaines salines (VarnÃ¤l, Sud-Rune)	Carapace utilisÃ©e pour stockage de selrune.
Cracheur dâ€™eau	Amphibien prÃ©dateur	RiviÃ¨res du Darn, deltas de Thaurgrim	ConsommÃ© localement ; rÃ©gule les moustiques aquatiques.
Grenouilles-lueurs	Amphibien bioluminescent	Marais de Darn	Source naturelle de lumiÃ¨re biochimique ; sert dâ€™indicateur sanitaire.
Iguane du vent	Reptile planeur herbivore	Canyons de Thaurgrim	Plane avec les courants chauds ; consomme mousses sulfurÃ©es.
ğŸ¦… IV. Oiseaux
EspÃ¨ce	Description	Habitat	ParticularitÃ©s Ã©cologiques
Corbeau noir	Oiseau charognard omniprÃ©sent	Tous biomes sauf glaciaires	Nettoyeur Ã©cologique, hautement intelligent.
Aigle de Fer	Rapace massif	Montagnes du Hraal, Fer-dâ€™Acier	PrÃ©dateur aÃ©rien ; utilisÃ© pour la chasse fÃ©odale.
GoÃ©land des brumes	Oiseau marin	CÃ´tes dâ€™HelrÃ¼n, Eldaron, Iskarion	Indicateur des courants du Fer-Bleu.
Hibou cendrÃ©	Rapace nocturne	ForÃªts tempÃ©rÃ©es	RÃ©gule les rongeurs ; symbolique de vigilance.
Faucon de guerre	DomestiquÃ© par lâ€™homme	Forteresses dâ€™Eldaron	Messager rapide, dressÃ© par les ordres militaires.
Albatros du Cendre	Grand oiseau marin migrateur	Courants du nord	Suit les gyres ocÃ©aniques, garant de lâ€™Ã©quilibre des mers.
Moineau gris	Petit insectivore	Villes, bourgs	Indicateur de pollution ; symbole de rÃ©silience.
Canard de Darn	PalmipÃ¨de	Marais tempÃ©rÃ©s	Base dâ€™Ã©levage local ; graisse utilisÃ©e en lampes.
Pingouin de d'Ygral	Oiseau marin non volant	Banquises dâ€™HelrÃ¼n	Colonies structurÃ©es ; ressource alimentaire borÃ©ale.
ğŸŸ V. Faune aquatique
EspÃ¨ce	Description	Zone	Usage / rÃ´le
Morue glacÃ©e	Poisson gras	Mers froides (HelrÃ¼n)	Alimentation des peuples nordiques.
Saumon du Draen	Migrateur fluvial	Fleuves dâ€™Eldaron	Ressource majeure des guildes et des temples.
Anguille des brumes	Poisson Ã©lectrique	Mer des Brumes	Source naturelle de nerith brut pour alchimie.
Requin des cendres	PrÃ©dateur marin	Courants du Cendre (Iskarion)	Chasseur apex, cuir utilisÃ© en armures.
Poisson de vase	Poisson plat	Marais du Darn	Nourriture commune.
Crabe rouge	CrustacÃ© gÃ©ant	CÃ´tes rocheuses (Eldaron, VarnÃ¤l)	Export gastronomique.
MÃ©duse noire	InvertÃ©brÃ© toxique	Mer dâ€™Elyr	BrÃ»lures chimiques ; rÃ©coltÃ©e pour son acide.
Baleine Ã  dos de cendre	CÃ©tacÃ© gÃ©ant	OcÃ©an de Cendre	Source dâ€™huile, rÃ´le Ã©cologique de brassage thermique.
Pieuvre des brumes	CÃ©phalopode intelligent	Mer des Brumes	EspÃ¨ce sociale, comestible, Ã©tudiÃ©e pour ses pigments.
ğŸœ VI. Insectes, invertÃ©brÃ©s et microfaune
Type	Habitat	ParticularitÃ©s
ScarabÃ©e de fer	Mines riches en grisfer	Exosquelette mÃ©tallique ; recycle les dÃ©chets ferriques.
Abeilles noires	ForÃªts du CÅ“ur dâ€™Eldaron	Miel sombre Ã  haute valeur Ã©nergÃ©tique.
Fourmi des sables	DÃ©serts de Sud-Rune	Colonies profondes ; aÃ¨re les sols arides.
AraignÃ©e du sel	Marais salins (VarnÃ¤l, Eldaron sud)	Fils rÃ©sistants utilisÃ©s pour textiles alchimiques.
Ver des neiges	Sous-glace dâ€™HelrÃ¼n	Carnivore discret ; entretient la chaÃ®ne alimentaire nordique.
Papillon dâ€™ambre	ForÃªts chaudes dâ€™Iskarion et VarnÃ¤l	Ailes translucides ; pollinisation des arbres dâ€™ambre.
Moucheron du Darn	Marais	Vecteur de maladies ; rÃ©gulÃ© par cracheurs dâ€™eau.
Sangsue dâ€™ombre	Eaux douces	UtilisÃ©e pour saignÃ©es mÃ©dicinales.
Luciole de nuit	Prairies et bords de forÃªts	Ã‰met un Ã©clat chimique non magique ; sert dâ€™Ã©clairage naturel.
ğŸ VII. Animaux domestiques et de travail
Animal	Usage	Origine	ParticularitÃ©s
Chien du fer	Garde, chasse	Eldaron, HelrÃ¼n	RÃ©sistant, loyal, sÃ©lectionnÃ© depuis le Loup cendrÃ©.
Cheval rude	Transport, guerre	Eldaron	Endurant, sâ€™adapte au froid et aux sols ferriques.
BÅ“uf du CÅ“ur	Labour	Eldaron central	Force tranquille, essentiel Ã  lâ€™agriculture.
ChÃ¨vre de Lorn	Lait, cuir	Eldaron / Thaurgrim	AdaptÃ©e aux reliefs volcaniques.
Mouton des collines	Laine	Eldaron	Source textile majeure.
Ã‚ne gris	Transport	Sud Eldaron / Thaurgrim	TrÃ¨s endurant, essentiel au commerce.
Porc rustique	Viande	Global	Omnivore et adaptable.
Canard du Darn	Ã‰levage	Eldaron sud	Graisse pour lampes, viande abondante.
Chat des greniers	Chasse-nuisibles	Global	Domestique universel.
ğŸ¦´ VIII. Principes Ã©cologiques et biogÃ©ographiques gÃ©nÃ©raux

HelrÃ¼n â†’ Faune adaptÃ©e au froid : graisse, fourrure, hibernation.

Eldaron â†’ Zone tempÃ©rÃ©e : diversitÃ© maximale, cohabitation homme/faune.

Thaurgrim â†’ Faune volcanique et tropicale : reptiles, insectes, amphibiens gÃ©ants.

Iskarion â†’ Faune cÃ´tiÃ¨re et insulaire : poissons Ã©lectriques, oiseaux marins, reptiles marins.

VarnÃ¤l â†’ Faune Ã©quatoriale : forÃªts humides, amphibiens gÃ©ants, pollinisateurs bioluminescents.

ChaÃ®nes Ã©cologiques

Producteurs primaires â†’ algues, mousses, lichens, herbes.

Herbivores â†’ cervidÃ©s, bovidÃ©s, reptiles vÃ©gÃ©tariens.

Omnivores â†’ suidÃ©s, canidÃ©s, oiseaux.

Carnivores â†’ loups, ours, fÃ©lins, reptiles.

DÃ©composeurs â†’ insectes ferriques, vers, champignons.

IntÃ©gration planÃ©taire

Les courants du Surn et du Fer-Bleu transportent spores, poissons migrateurs et crustacÃ©s.

Les migrations animales participent au cycle biologique global dÃ©fini dans la SynthÃ¨se planÃ©taire.

Les espÃ¨ces ferriques (ScarabÃ©e de fer, LÃ©zard des cendres, BÅ“uf des cendres) exploitent naturellement les ressources minÃ©rales de Thaurgrim et Iskarion, assurant le lien biologique avec la mÃ©tallurgie naturelle du monde.