üåç R√âPARTITION MONDIALE DES RESSOURCES BRUTES DE VELKARUM

(valeurs relatives exprim√©es en % du volume extractible mondial connu)

ü™® I. M√âTAUX ET MIN√âRAUX COMMUNS
Ressource	R√©partition (% mondiale)	Continents dominants	Justification g√©ologique
Fer rouge	28 % Thaurgrim, 26 % Iskarion, 22 % Varn√§l, 15 % Eldaron, 9 % Helr√ºn	Concentration maximale dans les cha√Ænes volcaniques (Vulkar, Derna) et zones s√©dimentaires ferriques.	Diffus√© par les √©ruptions de Thaurgrim et red√©pos√© par le Surn.
Grisfer	52 % Helr√ºn, 38 % Eldaron, 10 % reste du monde	Alliage ferrique natif issu du Bouclier de Skarnheim et du Fer-d‚ÄôAcier.	Polarisation magn√©tique nordique unique, li√©e au noyau plan√©taire.
Cuivre brut	35 % Thaurgrim, 27 % Iskarion, 20 % Eldaron, 18 % Varn√§l	Filons sulfureux et schistes cuprif√®res dans Drav, Derna et archipels iskarionnais.	Issu de l‚Äôorogen√®se m√©ridionale.
Argent	30 % Helr√ºn (Nerr), 27 % Eldaron, 24 % Iskarion, 19 % Thaurgrim	Filons argentif√®res des boucliers anciens et veines volcaniques.	Concentr√© dans zones de contact quartzif√®re.
Or	41 % Iskarion, 28 % Eldaron, 18 % Varn√§l, 13 % Thaurgrim	D√©rive volcanique et s√©dimentation alluviale c√¥ti√®re.	Iskarion = principal bassin aurif√®re.
√âtain / Zinc	38 % Varn√§l, 35 % Thaurgrim, 27 % Eldaron	Sous-produits de schistes et sables ferriques.	Exploit√©s dans zones tropicales humides.
Nickel	47 % Helr√ºn, 33 % Eldaron nord, 20 % Varn√§l	Poches de perg√©lisol m√©tallif√®res.	Associ√© au grisfer dans les boucliers anciens.
Charbon (noir/rouge)	34 % Thaurgrim, 30 % Eldaron, 26 % Iskarion, 10 % Helr√ºn	Lignite ferrique et tourbes fossiles.	R√©parti selon zones anciennes de for√™ts fossiles.
Pierre noire	50 % Iskarion, 40 % Thaurgrim, 10 % Eldaron	Roche magmatique √† forte densit√©.	Formation basaltique r√©cente.
Basalte / Obsidienne	45 % Thaurgrim, 32 % Varn√§l, 23 % Iskarion	Zones volcaniques actives ou fossiles.	Utilis√©e pour l‚Äôoutillage et la magie mat√©rielle.
Quartz clair/noir	30 % Varn√§l, 28 % Thaurgrim, 22 % Eldaron, 20 % Iskarion	Pr√©sent dans les falaises d‚ÄôObsidienne et les montagnes volcaniques.	Base de l‚Äôoptique et des flux √©nerg√©tiques.
Ambre fossile	48 % Eldaron, 38 % Helr√ºn, 14 % Varn√§l	D√©p√¥ts glaciaires fossilis√©s et for√™ts anciennes.	Base de catalyse organique.
Sel fossile / Selrune	33 % Varn√§l, 29 % Iskarion, 26 % Thaurgrim, 12 % Eldaron	Marais salins √©quatoriaux et zones d‚Äô√©vaporation.	Compos√© √©nerg√©tique naturel.
Soufre natif	39 % Thaurgrim (Thun‚Äôar, Vulkar), 31 % Iskarion, 18 % Eldaron, 12 % Varn√§l	D√©gazage volcanique et bassins s√©dimentaires.	Source chimique majeure.
Gaz naturel / soufr√©	36 % Thaurgrim, 29 % Eldaron, 23 % Iskarion, 12 % Helr√ºn	Champs volcaniques et marais anciens.	Base √©nerg√©tique et alchimique.
Skarnel	54 % Helr√ºn, 34 % Eldaron, 12 % Varn√§l	Roche m√©tamorphique des boucliers nordiques.	Isolant naturel exceptionnel.
Cendragh (basalte ferrique)	40 % Eldaron, 35 % Thaurgrim, 25 % Helr√ºn	Form√© par fusion volcanique lente.	Mat√©riau des grandes forges.
Lignite ferrique / Charbon rouge	57 % Thaurgrim (Ashraal, Kaar), 43 % Eldaron	Combustible ferrique dense.	Fait pont entre √©nergie et m√©tallurgie.
Sable ferrique	41 % Varn√§l, 37 % Iskarion, 22 % Thaurgrim	R√©sidu d‚Äô√©rosion volcanique et ferrique.	Utilis√© en filtration et verrerie.
Pierre de cendre / Cendre noire ‚Äî 60 % Helr√ºn (Orr), 40 % Thaurgrim (Vulkar)
Roche poreuse volcanique servant d‚Äôisolant thermique et de filtre alchimique.
‚öóÔ∏è II. SUBSTANCES CHIMIQUES ET ALCHEMIQUES
Ressource	R√©partition	Justification
Nerith	40 % Iskarion (marais ferriques), 30 % Thaurgrim, 20 % Eldaron, 10 % Varn√§l	Fluide bio-m√©tallique d√©riv√© de faune abyssale et sol ferrique.
Sangrel	68 % Eldaron Sud (Darn), 32 % Thaurgrim (Thun‚Äôar)	Boue vitale catalytique li√©e √† la faune amphibie.
Aetherite 45 % Helr√ºn (Skarnheim), 40 % Eldaron (Lunes Blanches / Fer-d‚ÄôAcier), 15 % Thaurgrim.	Cristal argent-quartz form√© sous haute pression.
Selrune	30 % Varn√§l, 27 % Thaurgrim, 26 % Eldaron, 17 % Iskarion	Sel luminescent des bassins salins.
Sang d‚Äôambre	50 % Eldaron, 35 % Helr√ºn, 15 % Iskarion	R√©sine organique des for√™ts bor√©ales et temp√©r√©es.
Tourbe noire	40 % Eldaron (Darn), 35 % Helr√ºn (Ygral), 25 % Iskarion	Stockage √©nerg√©tique fossile.
Soufre blanc	70 % Thaurgrim, 30 % Iskarion	Purification chimique de soufre volcanique.
Gaz d‚ÄôAru	55 % Thaurgrim, 45 % Eldaron	Gaz ferrique lourd des zones g√©othermiques.
Argiles ferriques / gypse rouge	38 % Eldaron, 32 % Thaurgrim, 30 % Varn√§l	Substrats min√©raux utilis√©s pour symboles techniques.
Sels luminescents	44 % Varn√§l (Falaises d‚ÄôObsidienne), 32 % Iskarion, 24 % Eldaron	Produits phosphorescents naturels.
üåø III. RESSOURCES V√âG√âTALES ET ORGANIQUES
Ressource	Principales zones	Proportion et coh√©rence
Bois rouge (Elyon/Rhaal)	Varn√§l, Eldaron sud	60 % Varn√§l (for√™t de Rhaal), 40 % Eldaron (Elyon).
Bois noir (Drav/Lorn)	Thaurgrim, Eldaron volcanique	65 % Thaurgrim, 35 % Lorn.
Latex ferrique	Varn√§l sud (for√™ts s√®ches)	100 % exclusif √† Varn√§l.
Herbes m√©dicinales	Eldaron, Thaurgrim, Varn√§l	R√©partition √©quilibr√©e : 40 % Eldaron, 35 % Thaurgrim, 25 % Varn√§l.
Champignons de Skarn/Vulkar	Helr√ºn, Thaurgrim	50 % chacun, li√©s √† milieux souterrains froids/chauds.
Lianes ferriques	Rhaal (Varn√§l), Drav (Thaurgrim)	55 % Rhaal, 45 % Drav.
Plantes salines	Sud-Rune, Marael	70 % Varn√§l (Marael), 30 % Eldaron (Sud-Rune).
Foug√®re sulfur√©e	Shaar, Thun‚Äôar	100 % Thaurgrim.
Arbres d‚Äôambre	Eldaron, Iskarion	70 % Eldaron, 30 % Iskarion.
Canne √† s√®ve	Elyon (Eldaron)	R√©partition limit√©e (100 % localis√©e).
üíß IV. RESSOURCES HYDRIQUES ET √âNERG√âTIQUES
Type	Principaux foyers	Part mondiale estim√©e	Remarques
Charbon / tourbe / lignite	Eldaron, Thaurgrim, Iskarion	33 / 37 / 30 %	Align√© avec zones de for√™ts fossiles.
Soufre / gaz / vapeur	Thaurgrim, Shaar, Vulkar	60 % concentr√© sud	Activit√© g√©othermique intense.
Vent polaire / ferrique	Helr√ºn, Kaar	100 % nordiques	R√©gulateurs atmosph√©riques.
Hydraulique (fleuves)	Eldaron, Iskarion	55 % Eldaron, 45 % Iskarion	Aliment√© par le Draen et l‚ÄôElyon.
G√©othermie / sources chaudes	Shaar, Vulkar, Velkar	70 % sud, 30 % centre	Sources thermales et volcans fossiles.
Mar√©es / courants oc√©aniques	Tous les continents c√¥tiers	r√©partition homog√®ne	Utilis√©es pour navigation et √©nergie.
√âlectricit√© naturelle (bio)	Faune marine et ver de Nerith	dispers√©e	Base de la proto-alchimie √©nerg√©tique.
üß™ V. CATALYSEURS MAGIQUES R√âALISTES
Nom	R√©partition mondiale	Contextes d‚Äôexploitation
Grisfer	90 % Helr√ºn / Eldaron	Conducteurs de flux, circuits m√©talliques.
Nerith	60 % Iskarion, 30 % Thaurgrim, 10 % Eldaron	Source fluide √©nerg√©tique.
Selrune	35 % Varn√§l, 30 % Thaurgrim, 25 % Eldaron, 10 % Iskarion	Sels luminescents stabilisateurs.
Aetherite  45 % Helr√ºn (Skarnheim), 40 % Eldaron (Lunes Blanches / Fer-d‚ÄôAcier), 15 % Thaurgrim.	Concentration vibratoire des flux m√©caniques.
Sangrel	65 % Eldaron (Darn), 35 % Thaurgrim	Support organique pour alchimie vitale.
Ambre noble	50 % Eldaron, 35 % Helr√ºn, 15 % Iskarion	Stockage du ‚Äúsouffle‚Äù √©nerg√©tique.
Soufre pur	75 % Thaurgrim, 25 % Iskarion	Propulsion chimique, transmutation.
Quartz noir / obsidienne	40 % Thaurgrim, 35 % Varn√§l, 25 % Iskarion	Confinement des flux.
Tourbe √©nerg√©tique	45 % Eldaron, 35 % Helr√ºn, 20 % Iskarion	Amortisseur alchimique.
Gaz ferrique	70 % Thaurgrim, 30 % Eldaron	Propulsion, forges sp√©ciales.
üåê SYNTH√àSE PAR CONTINENT
Continent	Ressources dominantes	Sp√©cificit√© √©nerg√©tique / alchimique	Part globale
Helr√ºn	Grisfer, nickel, skarnel, ambre, vent, tourbe	M√©taux magn√©tiques et isolants	~14 % du total plan√©taire
Eldaron	fer, argent, aetherite, ambre, sangrel, charbon	C≈ìur m√©tallurgique et scientifique	~22 %
Iskarion	fer, cuivre, or, nerith, soufre, quartz	G√©n√©rateur √©nerg√©tique et chimique	~20 %
Thaurgrim	fer rouge, cuivre, soufre, gaz, obsidienne, lignite	Diffuseur min√©ral et catalytique	~25 %
Varn√§l	fer, selrune, sables ferriques, latex, quartz, calcaire	√âquilibreur biologique et chimique	~19 %

‚úÖ Totaux coh√©rents avec la Synth√®se plan√©taire X (fonctions plan√©taires) :
Helr√ºn refroidit ; Eldaron r√©gule ; Iskarion alimente ; Thaurgrim diffuse ; Varn√§l √©quilibre.

‚öñÔ∏è CONCLUSION G√âO-√âNERG√âTIQUE

La distribution des ressources respecte les cycles plan√©taires :

Min√©raux ‚Üí diffus√©s par Thaurgrim et Iskarion.

Mati√®res organiques ‚Üí recycl√©es par Varn√§l et Eldaron.

√ânergies ‚Üí stabilis√©es par Helr√ºn et redistribu√©es via les gyres.

Les catalyseurs magiques r√©alistes (Grisfer, Nerith, Selrune, Aetherite, Sangrel) forment une ceinture technico-alchimique reliant les continents selon les courants oc√©aniques :
Helr√ºn ‚Üí Eldaron ‚Üí Thaurgrim ‚Üí Iskarion ‚Üí Varn√§l ‚Üí retour Fer-Bleu.