ü™® I. M√©taux et minerais communs
Ressource	Type	Continents principaux	Usage / propri√©t√©
Fer rouge	m√©tal pur	Iskarion, Thaurgrim, Varn√§l	armement, outillage
Grisfer	alliage ferrique magn√©tique	Helr√ºn, Eldaron	catalyse √©nerg√©tique, conductivit√© magique
Cuivre brut	m√©tal ductile	Eldaron, Thaurgrim, Iskarion	alliages, conduits
Argent	m√©tal noble	Eldaron, Helr√ºn, Iskarion	monnaies, instruments de pr√©cision
Or	m√©tal pr√©cieux	Iskarion, Eldaron, Morn√©a	ornement, alchimie, stockage d‚Äô√©nergie
√âtain / Zinc	m√©taux secondaires	Varn√§l, Thaurgrim	alliages, catalyse l√©g√®re
Nickel	m√©tal dur	Helr√ºn, Eldaron nord	alliages froids, r√©sistance aux flux
Charbon noir / rouge	fossile	Iskarion, Eldaron, Thaurgrim	√©nergie thermique, forges
Pierre noire	roche dure	Iskarion, Ghaarn	armes lourdes, b√¢timents fortifi√©s
Basalte / Obsidienne	vitreux volcanique	Thaurgrim, Morn√©a, Varn√§l	lames, miroirs, catalyseurs
Quartz clair / noir	silice cristalline	Iskarion, Varn√§l, Thaurgrim	optique, stockage de flux
Ambre fossile	r√©sine min√©ralis√©e	Eldaron, Helr√ºn	conducteur organique (liant magique)
Sel fossile / selrune	min√©ral	Eldaron Sud, Iskarion, Varn√§l	purification, stockage √©nerg√©tique
Soufre natif	chimique	Shaar, Thun‚Äôar, Orr	catalyse, explosifs, flux alchimiques
Gaz naturel / soufr√©	gazeux	Iskarion, Thaurgrim, Eldaron	combustion, distillation
Skarnel	roche cristalline dense	Eldaron, Helr√ºn	isolant thermique / blindage
Cendragh	basalte ferrique	Eldaron, Thaurgrim	r√©sistif, forge haute temp√©rature
Lignite ferrique / Charbon rouge	fossile min√©ralis√©	Thaurgrim, Kaar	combustible durable
Selrune purifi√©	sel √©nerg√©tique	Sud-Rune, Thaurgrim	base des catalyseurs magiques
Sable ferrique	minerai pulv√©ris√©	Varn√§l, Iskarion	filtration, verrerie technique
Pierre de cendre / Cendre noire	roche poreuse	Helr√ºn, Thaurgrim	isolation, filtre thermique
‚öóÔ∏è II. Substances chimiques et rares (alchimiques)
Ressource	Nature	Propri√©t√© scientifique / magique
Nerith	compos√© liquide instable (m√©lange ferreux et organique)	conducteur √©nerg√©tique √† froid, r√©agit √† la pression magn√©tique
Sangrel	boue organo-min√©rale des marais du Darn	catalyse biologique, sert d‚Äôagent de liaison dans les flux vitaux
Aetherite	cristal semi-translucide (argent + quartz)	concentre les champs vibratoires, fondement des flux magiques ma√Ætris√©s
Selrune	sel luminescent rare	stabilise les r√©actions chimiques, dissipe la chaleur magique
Sang d‚Äôambre	r√©sine liquide issue des arbres d‚Äôambre	liant organique isolant pour outils magiques
Tourbe noire	mati√®re fossile dense	conserve la chaleur et sert d‚Äôamortisseur √©nerg√©tique
Soufre blanc	d√©riv√© purifi√© du soufre natif	catalyse de combustion √† basse temp√©rature
Gaz d‚ÄôAru / gaz ferrique	gaz naturel lourd	stockage d‚Äô√©nergie compress√©e pour fourneaux et catalyseurs
Argiles ferriques / gypse rouge	substrats min√©raux	supports pour sigilles, symboles techniques grav√©s
Sels luminescents	sous-produit de Marael / Falaises d‚ÄôObsidienne	√©mettent une phosphorescence stable ‚Äî √©clairage non magique
üåø III. Ressources v√©g√©tales et organiques
Ressource	Zone	Usage
Bois rouge d‚ÄôElyon / Rhaal	zones tropicales	charpente, catalyse de chaleur
Bois noir de Drav / Lorn	volcaniques	combustible durable, armes
Latex ferrique	Varn√§l sud	isolant, scellant des circuits alchimiques
Herbes m√©dicinales	Tahl, Drav, Cenra	antidotes, r√©actifs
Champignons de Skarn / Vulkar	souterrains	absorbe les vapeurs, base d‚Äô√©lixirs
Lianes ferriques	Rhaal, Thaurgrim	cordage conducteur
Plantes salines / halophytes	Sud-Rune, Marael	extraction de sels purifi√©s
Foug√®re sulfur√©e	Shaar, Thun‚Äôar	filtre les gaz toxiques, purificateur biologique
Arbres d‚Äôambre / r√©sine noble	Eldaron, Iskarion	source de liant √©nerg√©tique organique
Canne √† s√®ve / sucre min√©ral	Elyon	carburant naturel pour proc√©d√©s chimiques doux
üíß IV. Ressources hydriques et √©nerg√©tiques
Ressource	Localisation	Type / usage
Charbon fossile / tourbe / lignite	Eldaron, Iskarion, Thaurgrim	√©nergie de forge, chauffage
Soufre / gaz / vapeur	Shaar, Thun‚Äôar, Vulkar	√©nergie thermique et catalyse alchimique
Vent polaire / vents ferriques	Helr√ºn, Surn, Kaar	√©nergie m√©canique, moulins, forge du vent
Hydraulique (fleuves du Draen, Elyon, Surn)	Eldaron, Iskarion	moulins, forges, circuits
G√©othermie / sources chaudes	Shaar, Vulkar, Velkar	bains, √©nergie stable
Mar√©es / courants oc√©aniques (Fer-Bleu, Surn)	c√¥tes mondiales	√©nergie m√©canique, navigation
√âlectricit√© naturelle (poisson-temp√™te, ver de nerith)	faune	premi√®res observations bio√©lectriques naturelles utilis√©es en alchimie

Notes :

Iskarion (Elyon) constitue la contre-partie d‚ÄôEldaron (Draen) dans la part mondiale hydraulique (55/45).

üß™ V. Ressources fictives ‚Äì catalyseurs magiques r√©alistes

(Issues de la g√©ologie et de la biologie, sans magie intrins√®que mais exploit√©es comme mati√®res premi√®res de l‚Äô‚Äúart magique‚Äù)

Nom	Type	Description scientifique plausible	Usage √©nerg√©tique / magique
Grisfer	m√©tal ferromagn√©tique	magn√©tisme naturel exceptionnel, conducteur d‚Äôondes vibratoires	base des armes et circuits magiques
Nerith	fluide organo-m√©tallique	√©met champ r√©actif √† la pression ou chaleur	source de flux √©nerg√©tique contr√¥l√©
Selrune	sel luminescent	stabilise les flux √©lectriques, dissipe chaleur magique	rune et sceaux
Aetherite	cristal semi-translucide	concentre vibrations m√©cano-sonores	catalyseur de sorts techniques
Sangrel	boue vitale organique	conductrice biologique, stockage de chaleur	m√©dium pour enchantements de vie
Ambre noble	r√©sine fossile	polarise l‚Äô√©lectricit√© statique	stockage de ‚Äúsouffle vital‚Äù artificiel
Soufre pur	min√©ral	combustible chimique	propulsion, transmutation
Quartz noir / obsidienne	silice dense	filtre √©nerg√©tique, ‚Äúmiroir‚Äù de flux	confinement et amplification
Tourbe √©nerg√©tique	organique	retient les vibrations thermiques	amortisseur pour rituels ou machines
Gaz ferrique	gazeux r√©actif	expansion thermique contr√¥lable	propulsion alchimique, m√©tallurgie subtile
‚öôÔ∏è Synth√®se g√©n√©rale

Ressources m√©talliques majeures : fer, grisfer, cuivre, or, argent, √©tain, nickel, skarnel.

Ressources alchimiques : nerith, sangrel, aetherite, selrune, ambre.

√ânergies primaires : charbon, vent, g√©othermie, mar√©es, gaz, vapeur.

Ressources biologiques : latex, bois, tourbe, champignons, plantes m√©dicinales.